1111111111111111111111111111111111111111
1011110111111111111111111111111111111111
1101101111111111111111111111111111111111
1000011111111111111110111111100001111111
1111011111111111111110111111111111111111
1111101111111111111110111111111111111111
1111110111111111111110111111111111111111
1111101011111111111110111111111111111111
1111011100011111111110111111111111111111
1111011111101111111110111111111111111111
1111011111101111111110111111111111111111
1111011111110111111110111111111111111111
1111011111110000011101111111111111111111
1111101111111111000011111111111111111111
1111100111111111101111111111111111111111
1111110011111111101111111111111111111111
1111101111111111101111111111111111111111
1111011111111111110000011110000000000111
1111101111111111111111000000111111111111
1111110111111111111111111111111111111111
1100101011111111111111111111111111111111
1111001001111111111111111111111111111111
1111111100000000000000000000000011111111
1111111111111111111111111111110101111111
1111111111111111111111111111110110111111
1111111111111111111111111111110111011111
1111111111111111111111111111110111101111
1111111111111111111111111111110111110111
1111111111111111111111111111110111110111
1111111111111111111111111111101111110111
1111111111111111111111111111011111110111
1111111111111111111111111110111111110111
1111111111111111111111111101111111110111
1111111111111111111111111011111111110111
1111111111111111111111111111111111110111
1111111111111111111111111111111111110111
1111111111111111111111111111111111110111
1111111111111111111111111111111111110111
1111111111111111111111111111111111111001
1111111111111111111111111111111111111111